20
10
8 0 19 9
12 5 5 5 5 6 13 6 12 7 
9 6 13 6 14 9 4 1 0 7 
14 9 4 3 9 6 9 4 1 6 
10 14 8 5 6 8 6 10 13 2 
8 2 10 12 1 2 11 9 7 11 
10 10 9 1 7 9 6 12 4 7 
10 9 4 5 7 13 0 3 9 6 
11 14 8 4 7 14 8 4 7 11 
6 8 1 1 5 0 0 1 7 14 
9 1 6 12 4 2 9 5 7 10 
13 5 3 11 10 8 7 14 14 10 
12 6 13 5 3 9 6 9 0 3 
10 10 14 13 4 4 3 14 10 14 
10 8 3 13 0 1 5 1 3 10 
11 9 4 4 0 7 14 14 13 2 
12 4 3 9 0 7 8 1 5 2 
10 10 13 4 0 7 8 4 7 11 
11 10 12 3 8 6 9 2 12 7 
12 2 11 14 10 9 4 1 1 7 
11 11 13 1 3 13 1 5 5 5 
