50
50
41 0 45 49
14 12 4 7 14 12 4 7 12 7 13 4 7 13 6 14 14 12 4 4 5 7 14 14 14 12 4 6 14 14 14 13 5 4 6 13 5 5 4 6 14 13 6 14 14 13 4 5 5 6 
9 2 10 14 10 8 0 5 0 6 12 2 13 6 8 3 8 2 10 11 12 7 10 10 9 3 11 10 10 8 1 6 13 3 9 6 12 5 2 8 1 5 3 10 8 4 1 7 14 10 
13 1 2 8 3 8 3 12 1 3 10 8 4 1 1 6 9 0 1 7 9 4 0 0 7 13 5 1 0 3 12 0 7 13 5 1 3 13 2 8 5 5 5 0 2 9 5 6 10 11 
12 7 8 0 6 11 12 1 4 5 3 8 2 12 4 3 13 0 5 4 5 3 11 10 13 4 6 13 3 12 1 0 6 13 6 12 6 14 11 9 6 14 12 3 10 14 13 0 3 14 
10 13 2 10 9 5 2 13 0 4 6 9 1 1 2 13 6 11 12 2 13 4 5 3 12 3 11 12 6 9 7 8 3 13 2 10 10 10 14 13 3 10 8 6 10 8 5 1 5 3 
8 6 9 1 6 12 2 13 1 3 9 7 14 14 9 6 9 6 8 0 7 9 7 14 8 5 6 9 2 13 6 8 6 12 0 3 11 8 2 12 5 0 3 11 11 9 7 14 13 6 
11 9 6 12 2 10 9 5 6 13 4 5 1 3 13 1 6 10 10 8 5 7 13 2 9 6 9 6 10 14 8 3 8 2 9 7 13 3 9 0 5 1 5 6 12 6 14 9 4 2 
13 4 0 1 3 11 12 5 0 7 10 12 4 7 12 6 9 2 11 8 4 6 14 9 6 9 6 8 1 0 0 5 1 0 7 14 12 4 4 0 7 14 13 1 0 1 3 12 3 10 
14 10 11 13 5 5 0 6 10 14 8 3 11 13 3 8 6 8 4 1 2 9 2 13 2 13 2 10 14 10 11 12 7 9 5 2 10 11 11 9 5 3 12 6 10 12 4 3 12 2 
10 8 5 5 5 7 9 3 8 3 8 7 12 7 14 11 10 10 11 14 11 12 0 7 8 5 3 11 8 1 6 10 12 5 4 2 11 14 12 7 13 5 2 11 8 3 11 14 10 10 
8 3 12 4 6 14 13 4 0 6 9 6 10 13 2 13 0 3 13 0 5 0 2 14 11 12 6 14 9 7 10 8 3 12 3 9 7 9 2 12 7 14 8 5 1 6 14 9 2 11 
10 12 2 11 9 3 13 2 11 10 12 1 1 5 1 6 9 7 13 2 13 3 10 8 5 3 8 2 13 6 10 11 14 11 14 14 13 6 8 1 6 8 2 13 6 11 9 5 1 7 
10 8 0 5 4 6 14 8 7 9 1 7 14 12 5 2 13 6 13 2 14 14 11 8 4 6 8 3 12 1 3 14 9 5 1 2 13 1 2 13 2 8 1 5 3 14 12 5 4 7 
10 9 0 5 0 3 8 0 4 6 12 7 10 8 7 10 12 0 5 2 10 8 6 10 11 11 9 5 3 13 5 1 4 5 5 2 13 4 0 7 8 0 7 13 6 10 9 6 8 7 
10 14 8 6 9 7 10 10 11 10 9 6 8 1 6 10 9 3 13 1 3 11 8 3 14 14 12 4 6 12 4 6 11 12 5 3 14 11 11 13 0 1 4 7 8 1 4 2 8 6 
11 9 3 10 13 5 0 3 12 1 7 8 1 7 11 9 6 14 13 6 13 4 2 12 1 3 9 0 2 8 0 0 6 9 6 12 1 5 5 4 3 12 0 5 1 5 2 11 10 11 
13 6 13 0 4 6 10 12 0 5 7 11 14 14 14 13 3 8 6 8 7 10 9 0 5 7 12 1 0 2 11 10 9 4 3 8 6 12 6 10 14 10 8 5 7 13 3 14 9 7 
12 0 5 0 0 1 3 9 3 12 4 7 9 0 0 6 14 9 2 9 6 11 12 0 7 13 0 7 8 1 6 10 13 2 13 3 10 11 8 2 9 2 10 13 5 6 13 2 12 6 
10 11 14 8 1 4 6 12 7 11 8 7 12 0 2 9 2 14 8 7 10 13 3 10 12 7 8 7 9 7 11 11 12 1 4 5 3 13 2 9 6 11 9 4 7 9 4 3 10 11 
10 13 2 10 14 11 11 9 5 5 0 6 9 2 11 14 9 3 9 4 1 5 5 0 3 12 0 6 13 6 12 7 9 7 11 14 14 14 10 13 1 7 14 10 12 5 1 4 1 7 
11 14 8 0 1 7 13 5 4 4 2 11 12 3 14 8 5 6 13 1 5 4 7 10 12 3 9 0 7 8 2 13 4 6 13 2 9 0 3 13 4 4 3 9 2 14 12 0 7 14 
13 2 11 8 5 7 12 7 10 10 9 6 10 13 2 10 14 9 5 6 14 9 6 9 0 5 7 11 14 8 0 7 11 8 7 9 5 0 5 6 10 9 5 6 8 3 11 11 12 2 
12 2 12 2 12 7 8 6 10 8 6 11 10 14 10 11 9 5 4 1 1 6 11 14 8 7 14 13 1 0 1 7 12 0 6 14 13 1 6 10 9 7 13 0 2 13 6 12 3 10 
10 11 11 9 0 4 0 2 10 11 9 4 2 9 0 5 4 4 3 14 12 0 5 0 1 5 0 4 5 0 5 4 0 3 8 3 12 4 3 11 12 5 7 8 3 13 2 8 7 11 
8 7 12 7 10 9 0 0 1 7 14 10 9 4 0 6 11 9 5 2 11 10 14 10 13 6 10 10 13 2 14 10 8 7 10 13 1 1 5 6 9 5 4 1 6 12 3 8 5 6 
10 12 3 12 2 14 10 10 14 14 9 1 5 2 8 3 12 6 12 2 12 3 9 0 5 2 9 3 13 0 3 10 11 13 2 12 4 4 4 0 6 14 8 7 9 2 14 9 4 2 
10 8 7 9 1 3 11 9 3 8 7 12 6 10 8 4 2 10 9 3 11 12 7 11 12 2 12 5 6 8 6 11 13 5 3 10 11 10 11 11 8 2 9 6 14 9 0 6 8 3 
8 1 5 7 13 5 4 4 6 8 5 2 10 10 10 11 11 11 13 5 4 3 13 6 11 10 9 7 9 3 9 7 12 4 7 11 13 1 4 7 10 9 7 9 2 12 3 8 2 14 
9 6 12 7 13 5 0 0 2 10 12 3 10 10 10 14 12 4 5 4 3 13 4 0 4 0 6 14 12 5 7 12 3 10 14 13 6 13 1 7 9 4 7 14 11 11 12 2 8 3 
14 9 2 13 6 14 10 10 9 2 8 7 8 3 9 1 3 11 13 0 7 13 3 10 10 11 9 2 9 6 13 0 7 11 10 12 0 4 5 4 5 0 6 10 14 14 10 9 1 7 
9 4 0 7 8 3 11 11 13 2 11 13 0 5 6 14 13 5 4 2 14 12 5 3 10 13 4 1 7 10 13 2 14 12 3 9 2 10 13 1 4 2 8 3 8 0 3 14 14 14 
14 11 8 5 2 13 4 6 14 10 14 14 11 13 2 10 12 5 3 9 3 8 7 14 8 4 0 6 12 0 5 2 9 0 6 14 10 11 13 5 3 9 2 12 3 9 4 1 3 10 
10 12 2 14 8 5 2 9 3 11 9 1 6 12 3 9 3 14 12 7 14 9 5 3 11 10 10 8 2 10 14 10 13 2 10 9 1 6 12 6 12 4 3 11 12 6 9 4 5 2 
10 9 1 0 1 7 9 7 12 6 12 7 9 1 4 4 7 9 2 12 2 12 4 4 7 10 10 11 11 10 9 1 5 2 10 13 4 0 3 10 11 11 13 6 11 10 13 2 13 2 
9 6 14 9 6 12 6 12 2 9 1 5 6 13 0 0 6 14 10 10 11 11 10 8 7 10 11 12 7 11 14 13 4 3 11 12 2 11 12 1 5 5 7 8 4 1 6 8 7 10 
13 1 0 5 3 10 11 11 10 12 7 14 8 4 3 11 8 1 3 10 14 14 10 11 12 1 4 1 6 14 9 6 9 6 12 2 11 14 11 13 6 12 6 9 2 14 8 3 13 2 
12 6 8 7 14 8 5 5 1 3 13 1 1 0 5 6 11 14 14 10 8 0 1 7 11 13 1 6 9 3 13 1 5 2 11 9 7 9 5 6 10 10 11 13 3 9 2 13 6 11 
9 1 1 4 1 1 7 14 14 12 6 12 7 10 12 1 4 0 0 1 0 0 6 12 6 13 6 10 12 7 12 4 7 11 14 12 4 6 14 10 8 3 14 13 4 6 8 6 9 6 
13 4 5 2 14 13 4 3 8 3 9 2 13 2 11 13 1 2 8 7 8 3 8 3 9 5 3 8 0 6 10 11 14 14 8 3 10 11 10 9 0 6 9 6 10 11 11 9 5 2 
12 2 14 9 0 4 1 5 1 5 7 9 6 9 5 5 5 3 10 13 3 14 9 7 12 6 12 2 10 9 3 12 0 2 11 13 0 5 1 5 3 10 14 8 2 13 4 5 6 11 
11 10 8 7 11 8 5 4 4 4 6 13 0 5 4 7 13 5 2 14 13 1 6 12 3 9 1 2 8 6 12 3 11 10 13 4 1 5 4 4 7 8 0 3 9 6 9 6 9 7 
4 1 1 5 7 11 12 3 10 8 2 14 10 14 9 6 13 5 3 9 5 6 10 9 7 13 6 11 11 11 8 7 14 8 5 3 12 4 3 10 14 11 11 12 6 10 14 9 4 6 
9 5 4 7 12 7 9 7 11 10 9 2 9 3 14 10 12 6 12 5 4 0 0 6 12 4 2 14 12 4 3 14 9 2 14 14 11 8 7 9 0 4 7 11 10 9 0 4 3 11 
14 13 3 14 9 4 5 5 4 0 4 3 13 5 1 3 9 2 10 14 11 11 10 9 3 10 10 9 2 9 7 9 4 1 2 10 13 3 13 6 8 3 13 4 1 7 10 9 5 7 
9 4 6 8 5 1 4 6 9 3 9 6 14 12 4 7 14 10 11 9 6 13 0 7 12 3 9 7 10 12 6 13 0 5 1 2 12 7 14 9 0 7 12 2 12 5 0 5 5 7 
14 11 9 3 14 14 10 8 5 6 13 3 10 11 8 4 2 10 13 6 10 12 1 6 11 12 7 13 0 2 11 13 2 12 4 0 0 6 10 13 2 12 3 11 10 13 0 5 5 4 
9 5 6 12 2 10 8 3 12 1 6 13 1 4 1 2 9 0 5 1 0 1 7 9 5 2 12 5 1 0 6 13 1 0 2 11 9 0 3 12 1 1 7 13 3 14 11 12 7 11 
13 4 0 3 9 2 10 12 0 7 8 5 5 3 12 1 6 11 13 5 1 4 4 5 7 8 0 7 13 2 8 6 13 3 9 6 12 2 14 8 4 5 7 13 6 8 5 1 5 7 
14 10 8 5 4 0 2 11 8 7 9 7 14 13 0 6 10 12 6 14 13 2 10 13 6 11 9 7 14 10 11 10 13 5 4 0 2 10 10 8 1 5 5 4 2 8 5 7 12 6 
9 3 9 5 3 11 11 13 1 5 5 5 1 7 9 3 9 3 9 1 7 11 9 5 1 5 5 7 9 3 13 1 5 7 11 11 11 9 3 9 5 7 13 3 9 1 5 5 3 11 
