10
20
4 0 8 19
12 5 6 12 5 4 6 12 7 12 7 14 14 12 5 7 13 4 5 6 
8 7 10 9 6 11 11 8 4 2 12 0 0 2 12 7 14 11 12 2 
11 14 8 7 8 4 6 11 11 9 2 9 2 11 9 4 0 4 2 11 
12 1 0 6 9 3 8 7 14 13 0 7 9 7 14 8 2 9 2 14 
2 13 1 1 4 5 1 6 8 5 2 12 4 5 0 3 9 7 9 2 
10 13 4 4 1 7 14 10 8 5 2 11 8 7 8 5 4 5 7 11 
9 7 11 9 5 6 10 10 10 13 0 5 2 13 2 14 10 13 4 6 
13 5 6 14 13 2 9 2 8 7 8 7 10 13 2 8 0 4 3 10 
13 6 8 1 4 2 14 8 3 12 0 6 9 6 10 10 11 11 12 1 
13 1 3 13 3 11 9 1 7 11 11 9 7 11 11 9 5 7 9 7 
