17
17
0 15 16 6
12 6 14 14 14 14 12 6 12 4 5 4 6 12 6 8 6 
11 10 10 8 1 0 3 11 10 8 7 11 9 3 11 10 11 
14 9 1 1 7 10 12 5 2 11 14 13 4 5 7 10 14 
10 12 7 14 12 3 11 13 2 14 8 6 8 4 5 2 10 
9 1 4 1 2 14 12 7 9 2 8 3 11 10 13 1 3 
14 13 2 13 0 1 2 13 6 10 10 13 4 2 14 14 14 
10 12 3 12 0 7 9 6 10 10 9 6 9 0 3 10 10 
9 3 12 0 1 6 13 0 2 9 4 3 12 0 7 8 2 
13 5 0 1 7 11 12 1 1 6 8 4 3 9 6 9 2 
13 5 3 12 5 5 2 14 14 9 2 9 7 13 3 12 2 
12 4 4 3 13 5 2 8 2 13 1 4 6 14 12 3 11 
10 9 1 6 14 13 2 11 8 7 12 2 8 3 10 14 14 
9 4 6 10 10 14 8 5 3 13 3 9 2 13 0 2 10 
13 3 11 10 10 9 0 5 5 5 5 7 8 4 3 8 3 
12 6 13 3 9 6 10 12 6 13 4 5 2 10 13 0 6 
10 8 4 4 4 0 3 10 8 6 8 7 11 9 6 11 10 
11 11 11 11 11 11 12 3 11 9 1 5 5 7 9 7 11 
